1111111111111111111111111111111111
1E000000000N000C00000C000000000001
1N10010100100000101001000N00010101
1010010010101010001001000000010101
1010010010101010001001000000010101
10100100101010100010010000000101N1
1P0000000C00C0000N00000N00000000C1
1111111111111111111111111111111111